30 30
3 4
111111111111111111111111111111
100000000000000000000000000001
100000000000000000010000000001
100000111111111111111110000001
100000100000000000010000000001
100000100000000000010000000001
100000100000000000010000000001
100000100000000000010000000001
100000100000000000010000000001
100000100000000000010000000001
100000100000000000010011111111
100000100000000000010000000001
100000100000111000010000000001
100000100000101000010000000001
100000100000111000010000000001
100000000000000000010000000001
111111000000000000010000000001
100000000000000000010000000001
100000000000000000010000000001
100000111111111111111111111001
100000000000000000010000000001
100000000000000000010000000001
100000000000000000010000000001
100000000000000000010000000001
100011111111111111100000111111
100000000000000000010000000001
100000000110000000010000000001
100000000110000000010000000001
100000000110000000000000000001
111111111111111111111111111111
